Image,Class,Num Detections,Num Tumor: Negative,Num Tumor: Positive,Tumor: Positive %
PKR-1-ck17_ceam.ndpi ,Septa 1,457,57,400,87.53
PKR-1-ck17_ceam.ndpi ,Septa 2,403,11,392,97.27
PKR-1-ck17_ceam.ndpi ,Lob 3,345,18,327,94.78
PKR-1-ck17_ceam.ndpi ,Septa 5,361,6,355,98.34
PKR-1-ck17_ceam.ndpi ,Lob 4,347,35,312,89.91
PKR-1-ck17_ceam.ndpi ,Lob 1,347,38,309,89.05
PKR-1-ck17_ceam.ndpi ,Lob 5,315,11,304,96.51
PKR-1-ck17_ceam.ndpi ,Lob 2,404,10,394,97.52
PKR-1-ck17_ceam.ndpi ,Septa 8,324,41,283,87.35
PKR-1-ck17_ceam.ndpi ,Septa 7,394,8,386,97.97
PKR-1-ck17_ceam.ndpi ,Septa 3,371,22,349,94.07
PKR-1-ck17_ceam.ndpi ,Septa 4,340,11,329,96.76
PKR-1-ck17_ceam.ndpi ,Septa 9,383,5,378,98.69
PKR-1-ck17_ceam.ndpi ,Septa 6,315,7,308,97.78
PKR-1-muc5ac_muc6.ndpi,Lob 5,413,299,114,27.6
PKR-1-muc5ac_muc6.ndpi,Lob 4,398,335,63,15.83
PKR-1-muc5ac_muc6.ndpi,Septa 1,527,482,45,8.539
PKR-1-muc5ac_muc6.ndpi,Septa 2,468,454,14,2.991
PKR-1-muc5ac_muc6.ndpi,Septa 3,362,308,54,14.92
PKR-1-muc5ac_muc6.ndpi,Septa 4,425,330,95,22.35
PKR-1-muc5ac_muc6.ndpi,Septa 5,444,400,44,9.91
PKR-1-muc5ac_muc6.ndpi,Septa 6,441,360,81,18.37
PKR-1-muc5ac_muc6.ndpi,Septa 8,402,286,116,28.86
PKR-1-muc5ac_muc6.ndpi,Lob 3,384,328,56,14.58
PKR-1-muc5ac_muc6.ndpi,Lob 1,333,289,44,13.21
PKR-1-muc5ac_muc6.ndpi,Septa 9,341,308,33,9.677
PKR-1-muc5ac_muc6.ndpi,Septa 7,351,190,161,45.87
PKR-1-muc5ac_muc6.ndpi,Lob 2,345,259,86,24.93
PKR-1-wt1_ca125.ndpi,Lob 1,333,223,110,33.03
PKR-1-wt1_ca125.ndpi,Lob 4,366,183,183,50
PKR-1-wt1_ca125.ndpi,Lob 5,343,256,87,25.36
PKR-1-wt1_ca125.ndpi,Septa 1,386,175,211,54.66
PKR-1-wt1_ca125.ndpi,Septa 2,494,102,392,79.35
PKR-1-wt1_ca125.ndpi,Septa 3,401,245,156,38.9
PKR-1-wt1_ca125.ndpi,Septa 4,336,99,237,70.54
PKR-1-wt1_ca125.ndpi,Septa 5,387,168,219,56.59
PKR-1-wt1_ca125.ndpi,Septa 6,333,123,210,63.06
PKR-1-wt1_ca125.ndpi,Septa 7,366,221,145,39.62
PKR-1-wt1_ca125.ndpi,Septa 8,345,120,225,65.22
PKR-1-wt1_ca125.ndpi,Septa 9,324,144,180,55.56
PKR-1-wt1_ca125.ndpi,Lob 2,322,201,121,37.58
PKR-1-wt1_ca125.ndpi,Lob 3,374,172,202,54.01
PKR-11-ck17_ceam.ndpi,Lob 2,337,28,309,91.69
PKR-11-ck17_ceam.ndpi,Lob 4,347,22,325,93.66
PKR-11-ck17_ceam.ndpi,Lob 5,652,38,614,94.17
PKR-11-ck17_ceam.ndpi,,0,0,0,
PKR-11-ck17_ceam.ndpi,,31,0,0,
PKR-11-ck17_ceam.ndpi,Lob 3,322,28,294,91.3
PKR-11-ck17_ceam.ndpi,Lob 7,518,12,506,97.68
PKR-11-ck17_ceam.ndpi,Lob 8,325,14,311,95.69
PKR-11-ck17_ceam.ndpi,Lob 9,508,18,490,96.46
PKR-11-ck17_ceam.ndpi,Septa 1,371,19,352,94.88
PKR-11-ck17_ceam.ndpi,Septa 2,325,15,310,95.38
PKR-11-ck17_ceam.ndpi,Septa 3,334,10,324,97.01
PKR-11-ck17_ceam.ndpi,,357,11,346,96.92
PKR-11-ck17_ceam.ndpi,Septa 4,541,10,531,98.15
PKR-11-ck17_ceam.ndpi,Septa 5,356,5,351,98.6
PKR-11-ck17_ceam.ndpi,Septa 6,375,6,369,98.4
PKR-11-ck17_ceam.ndpi,Septa 7,383,4,379,98.96
PKR-11-ck17_ceam.ndpi,Septa 8,371,4,367,98.92
PKR-11-ck17_ceam.ndpi,,0,0,0,
PKR-11-ck17_ceam.ndpi,Septa 9,329,8,321,97.57
PKR-11-ck17_ceam.ndpi,Lob (C),494,469,25,5.061
PKR-11-ck17_ceam.ndpi,Lob 1,494,469,25,5.061
PKR-11-ck17_ceam.ndpi,Lob 6,327,74,253,77.37
PKR-11-ck17_ceam.ndpi,Lob (C),327,74,253,77.37
PKR-11-muc5ac_muc6.ndpi,Lob 2,347,273,74,21.33
PKR-11-muc5ac_muc6.ndpi,Lob 3,313,255,58,18.53
PKR-11-muc5ac_muc6.ndpi,Lob 4,407,309,98,24.08
PKR-11-muc5ac_muc6.ndpi,Lob 5,394,369,25,6.345
PKR-11-muc5ac_muc6.ndpi,Lob 7,355,248,107,30.14
PKR-11-muc5ac_muc6.ndpi,Lob 8,424,409,15,3.538
PKR-11-muc5ac_muc6.ndpi,Lob 9,364,305,59,16.21
PKR-11-muc5ac_muc6.ndpi,Septa 1,318,308,10,3.145
PKR-11-muc5ac_muc6.ndpi,Septa 2,308,273,35,11.36
PKR-11-muc5ac_muc6.ndpi,Septa 3,314,312,2,0.6369
PKR-11-muc5ac_muc6.ndpi,Septa 4,383,377,6,1.567
PKR-11-muc5ac_muc6.ndpi,Septa 5,345,322,23,6.667
PKR-11-muc5ac_muc6.ndpi,Septa 6,302,271,31,10.26
PKR-11-muc5ac_muc6.ndpi,Septa 7,349,333,16,4.585
PKR-11-muc5ac_muc6.ndpi,Septa 8,372,327,45,12.1
PKR-11-muc5ac_muc6.ndpi,Septa 9,327,229,98,29.97
PKR-11-muc5ac_muc6.ndpi,Lob (C),347,22,325,93.66
PKR-11-muc5ac_muc6.ndpi,Lob (C),349,147,202,57.88
PKR-11-muc5ac_muc6.ndpi,Lob 1,347,22,325,93.66
PKR-11-muc5ac_muc6.ndpi,Lob 6,349,147,202,57.88
PKR-11-wt1_ca125.ndpi,Lob 2,303,302,1,0.33
PKR-11-wt1_ca125.ndpi,Lob 3,337,337,0,0
PKR-11-wt1_ca125.ndpi,Lob 4,483,483,0,0
PKR-11-wt1_ca125.ndpi,Lob 5,500,500,0,0
PKR-11-wt1_ca125.ndpi,Lob 7,391,382,9,2.302
PKR-11-wt1_ca125.ndpi,Lob 8,444,436,8,1.802
PKR-11-wt1_ca125.ndpi,Lob 9,510,507,3,0.5882
PKR-11-wt1_ca125.ndpi,Septa 1,339,329,10,2.95
PKR-11-wt1_ca125.ndpi,Septa 2,441,441,0,0
PKR-11-wt1_ca125.ndpi,Septa 3,477,477,0,0
PKR-11-wt1_ca125.ndpi,Septa 4,463,462,1,0.216
PKR-11-wt1_ca125.ndpi,Septa 5,368,368,0,0
PKR-11-wt1_ca125.ndpi,Septa 6,384,376,8,2.083
PKR-11-wt1_ca125.ndpi,Septa 7,321,306,15,4.673
PKR-11-wt1_ca125.ndpi,Septa 8,399,383,16,4.01
PKR-11-wt1_ca125.ndpi,Septa 9,621,621,0,0
PKR-11-wt1_ca125.ndpi,Lob (C),357,357,0,0
PKR-11-wt1_ca125.ndpi,Lob (C),402,402,0,0
PKR-11-wt1_ca125.ndpi,Lob 1,402,402,0,0
PKR-11-wt1_ca125.ndpi,Lob 6,357,357,0,0
PKR-16-ck17_ceam.ndpi,Septa 1,380,193,187,49.21
PKR-16-ck17_ceam.ndpi,Septa 2,321,245,76,23.68
PKR-16-ck17_ceam.ndpi,Septa 3,316,181,135,42.72
PKR-16-ck17_ceam.ndpi,Septa 4,303,15,288,95.05
PKR-16-ck17_ceam.ndpi,Septa 5,461,50,411,89.15
PKR-16-ck17_ceam.ndpi,Septa 6,323,28,295,91.33
PKR-16-ck17_ceam.ndpi,Septa 7,398,259,139,34.92
PKR-16-ck17_ceam.ndpi,Septa 8,317,261,56,17.67
PKR-16-ck17_ceam.ndpi,Septa 9,412,403,9,2.184
PKR-16-ck17_ceam.ndpi,Lob 1,360,359,1,0.2778
PKR-16-ck17_ceam.ndpi,Lob 2,384,384,0,0
PKR-16-ck17_ceam.ndpi,Lob 3,330,328,2,0.6061
PKR-16-ck17_ceam.ndpi,Lob 4,329,328,1,0.304
PKR-16-ck17_ceam.ndpi,Lob 5,430,427,3,0.6977
PKR-16-ck17_ceam.ndpi,Lob 6,386,383,3,0.7772
PKR-16-ck17_ceam.ndpi,Lob 7,510,510,0,0
PKR-16-ck17_ceam.ndpi,Lob 9,555,487,68,12.25
PKR-16-ck17_ceam.ndpi,Lob 8,378,351,27,7.143
PKR-16-muc5a_muc6.ndpi,Septa 2,326,254,72,22.09
PKR-16-muc5a_muc6.ndpi,Septa 3,335,251,84,25.07
PKR-16-muc5a_muc6.ndpi,Septa 4,417,326,91,21.82
PKR-16-muc5a_muc6.ndpi,Septa 5,333,255,78,23.42
PKR-16-muc5a_muc6.ndpi,Septa 6,378,338,40,10.58
PKR-16-muc5a_muc6.ndpi,Septa 7,444,436,8,1.802
PKR-16-muc5a_muc6.ndpi,Septa 8,444,435,9,2.027
PKR-16-muc5a_muc6.ndpi,Septa 9,400,388,12,3
PKR-16-muc5a_muc6.ndpi,Lob 1,364,203,161,44.23
PKR-16-muc5a_muc6.ndpi,Lob 2,339,126,213,62.83
PKR-16-muc5a_muc6.ndpi,Lob 3,349,176,173,49.57
PKR-16-muc5a_muc6.ndpi,Lob 4,370,170,200,54.05
PKR-16-muc5a_muc6.ndpi,Lob 5,366,204,162,44.26
PKR-16-muc5a_muc6.ndpi,Lob 6,326,183,143,43.87
PKR-16-muc5a_muc6.ndpi,Lob 8,323,262,61,18.89
PKR-16-muc5a_muc6.ndpi,Septa 1,353,164,189,53.54
PKR-16-muc5a_muc6.ndpi,Lob 7,319,95,224,70.22
PKR-16-muc5a_muc6.ndpi,Lob 9,341,202,139,40.76
PKR-16-wt1_ca125.ndpi,Septa 1,435,418,17,3.908
PKR-16-wt1_ca125.ndpi,Septa 2,335,329,6,1.791
PKR-16-wt1_ca125.ndpi,Septa 3,355,281,74,20.85
PKR-16-wt1_ca125.ndpi,Septa 4,379,125,254,67.02
PKR-16-wt1_ca125.ndpi,Septa 5,440,82,358,81.36
PKR-16-wt1_ca125.ndpi,Septa 6,393,193,200,50.89
PKR-16-wt1_ca125.ndpi,Septa 7,461,458,3,0.6508
PKR-16-wt1_ca125.ndpi,Septa 8,519,519,0,0
PKR-16-wt1_ca125.ndpi,Septa 9,439,438,1,0.2278
PKR-16-wt1_ca125.ndpi,Lob 1,355,355,0,0
PKR-16-wt1_ca125.ndpi,Lob 2,404,404,0,0
PKR-16-wt1_ca125.ndpi,Lob 3,310,310,0,0
PKR-16-wt1_ca125.ndpi,Lob 4,328,328,0,0
PKR-16-wt1_ca125.ndpi,Lob 5,316,316,0,0
PKR-16-wt1_ca125.ndpi,Lob 6,324,324,0,0
PKR-16-wt1_ca125.ndpi,Lob 7,392,392,0,0
PKR-16-wt1_ca125.ndpi,Lob 8,307,307,0,0
PKR-16-wt1_ca125.ndpi,Lob 9,426,340,86,20.19
PKR-11-p63_ck5.ndpi,Lob 2,304,297,7,2.303
PKR-11-p63_ck5.ndpi,Septa 6,333,329,4,1.201
PKR-11-p63_ck5.ndpi,Lob 7,388,350,38,9.794
PKR-16-ck5_cd10.ndpi,Septa 7,343,307,36,10.5
PKR-16-ck5_cd10.ndpi,Lob 9,370,253,117,31.62
PKR-16-ck5_cd10.ndpi,Lob 8,307,305,2,0.6515
PKR-16-ck5_cd10.ndpi,Lob 7,324,324,0,0
PKR-16-ck5_cd10.ndpi,Lob 3,314,303,11,3.503
PKR-16-ck5_cd10.ndpi,Lob 2,349,346,3,0.8596
PKR-16-ck5_cd10.ndpi,Lob 1,367,355,12,3.27
PKR-16-ck5_cd10.ndpi,Septa 1,301,123,178,59.14
PKR-16-ck5_cd10.ndpi,Septa 2,340,286,54,15.88
PKR-16-ck5_cd10.ndpi,Septa 3,353,266,87,24.65
PKR-16-ck5_cd10.ndpi,Septa 4,301,3,298,99
PKR-16-ck5_cd10.ndpi,Septa 5,337,4,333,98.81
PKR-16-ck5_cd10.ndpi,Septa 6,431,64,367,85.15
PKR-16-ck5_cd10.ndpi,Lob 5,322,322,0,0
PKR-16-ck5_cd10.ndpi,Lob 6,315,315,0,0
PKR-16-ck5_cd10.ndpi,Lob 4,346,343,3,0.8671
PKR-16-ck5_cd10.ndpi,Septa 8,399,397,2,0.5013
PKR-16-ck5_cd10.ndpi,Septa 9,390,388,2,0.5128
PKR-11-hmga2_ck19.ndpi,Septa 1,308,265,43,13.96
PKR-11-hmga2_ck19.ndpi,Septa 2,326,316,10,3.067
PKR-11-hmga2_ck19.ndpi,Septa 3,316,222,94,29.75
PKR-11-hmga2_ck19.ndpi,Septa 4,418,303,115,27.51
PKR-11-hmga2_ck19.ndpi,Septa 5,310,249,61,19.68
PKR-11-hmga2_ck19.ndpi,Septa 6,304,277,27,8.882
PKR-11-hmga2_ck19.ndpi,Septa 7,357,341,16,4.482
PKR-11-hmga2_ck19.ndpi,Septa 8,380,272,108,28.42
PKR-11-hmga2_ck19.ndpi,Septa 9,355,352,3,0.8451
PKR-11-hmga2_ck19.ndpi,Lob 1,394,355,39,9.898
PKR-11-hmga2_ck19.ndpi,Lob 6,369,301,68,18.43
PKR-11-hmga2_ck19.ndpi,Lob 2,316,315,1,0.3165
PKR-11-hmga2_ck19.ndpi,Lob 3,355,352,3,0.8451
PKR-11-hmga2_ck19.ndpi,Lob 4,314,310,4,1.274
PKR-11-hmga2_ck19.ndpi,Lob 5,314,276,38,12.1
PKR-11-hmga2_ck19.ndpi,Lob 7,304,275,29,9.539
PKR-11-hmga2_ck19.ndpi,Lob 8,319,209,110,34.48
PKR-11-hmga2_ck19.ndpi,Lob 9,341,289,52,15.25
PKR-16-hmga2_ck19.ndpi,Septa 1,381,372,9,2.362
PKR-16-hmga2_ck19.ndpi,Septa 2,326,316,10,3.067
PKR-16-hmga2_ck19.ndpi,Septa 3,319,244,75,23.51
PKR-16-hmga2_ck19.ndpi,Septa 4,350,196,154,44
PKR-16-hmga2_ck19.ndpi,Septa 5,323,291,32,9.907
PKR-16-hmga2_ck19.ndpi,Septa 6,422,311,111,26.3
PKR-16-hmga2_ck19.ndpi,Lob 2,303,300,3,0.9901
PKR-16-hmga2_ck19.ndpi,Lob 3,308,304,4,1.299
PKR-16-hmga2_ck19.ndpi,Lob 4,349,343,6,1.719
PKR-16-hmga2_ck19.ndpi,Lob 6,304,301,3,0.9868
PKR-16-hmga2_ck19.ndpi,Lob 5,329,329,0,0
PKR-16-hmga2_ck19.ndpi,Lob 7,437,437,0,0
PKR-16-hmga2_ck19.ndpi,Lob 8,324,323,1,0.3086
PKR-16-hmga2_ck19.ndpi,Lob 9,447,445,2,0.4474
PKR-16-hmga2_ck19.ndpi,Septa 7,314,314,0,0
PKR-16-hmga2_ck19.ndpi,Septa 8,435,434,1,0.2299
PKR-16-hmga2_ck19.ndpi,Septa 9,369,368,1,0.271
PKR-16-hmga2_ck19.ndpi,Lob 1,317,314,3,0.9464
PKR-1-cdx2_ca199.ndpi,Lob 1,302,294,8,2.649
PKR-1-cdx2_ca199.ndpi,Lob 2,317,317,0,0
PKR-1-cdx2_ca199.ndpi,Lob 3,300,281,19,6.333
PKR-1-cdx2_ca199.ndpi,Lob 4,310,309,1,0.3226
PKR-1-cdx2_ca199.ndpi,Lob 5,318,302,16,5.031
PKR-1-cdx2_ca199.ndpi,Septa 1,312,311,1,0.3205
PKR-1-cdx2_ca199.ndpi,Septa 2,390,386,4,1.026
PKR-1-cdx2_ca199.ndpi,Septa 3,354,353,1,0.2825
PKR-1-cdx2_ca199.ndpi,Septa 4,398,383,15,3.769
PKR-1-cdx2_ca199.ndpi,Septa 5,349,344,5,1.433
PKR-1-cdx2_ca199.ndpi,Septa 6,324,322,2,0.6173
PKR-1-cdx2_ca199.ndpi,Septa 7,361,359,2,0.554
PKR-1-cdx2_ca199.ndpi,Septa 8,303,302,1,0.33
PKR-1-cdx2_ca199.ndpi,Septa 9,517,517,0,0
PKR-16-cdx2_ca199.ndpi,Lob 1,367,331,36,9.809
PKR-16-cdx2_ca199.ndpi,Lob 2,372,321,51,13.71
PKR-16-cdx2_ca199.ndpi,Lob 3,326,307,19,5.828
PKR-16-cdx2_ca199.ndpi,Lob 4,321,318,3,0.9346
PKR-16-cdx2_ca199.ndpi,Lob 5,303,290,13,4.29
PKR-16-cdx2_ca199.ndpi,Lob 6,309,297,12,3.883
PKR-16-cdx2_ca199.ndpi,Lob 7,408,403,5,1.225
PKR-16-cdx2_ca199.ndpi,Lob 8,304,302,2,0.6579
PKR-16-cdx2_ca199.ndpi,Lob 9,360,308,52,14.44
PKR-16-cdx2_ca199.ndpi,Septa 1,332,331,1,0.3012
PKR-16-cdx2_ca199.ndpi,Septa 2,305,302,3,0.9836
PKR-16-cdx2_ca199.ndpi,Septa 3,326,326,0,0
PKR-16-cdx2_ca199.ndpi,Septa 4,310,310,0,0
PKR-16-cdx2_ca199.ndpi,Septa 5,321,321,0,0
PKR-16-cdx2_ca199.ndpi,Septa 6,325,325,0,0
PKR-16-cdx2_ca199.ndpi,Septa 7,326,326,0,0
PKR-16-cdx2_ca199.ndpi,Septa 8,359,359,0,0
PKR-16-cdx2_ca199.ndpi,Septa 9,344,344,0,0
