Image,Class,Num Detections,Num Tumor: Negative,Num Tumor: Positive,Tumor: Positive %
PKR-2-ck17_ceam_2.ndpi,Lob 1,489,484,5,1.022
PKR-2-ck17_ceam_2.ndpi,Lob 2,319,227,92,28.84
PKR-2-ck17_ceam_2.ndpi,Lob 3,417,323,94,22.54
PKR-2-ck17_ceam_2.ndpi,Lob 4,300,244,56,18.67
PKR-2-ck17_ceam_2.ndpi,Lob 6,405,311,94,23.21
PKR-2-ck17_ceam_2.ndpi,Lob 5,339,312,27,7.965
PKR-2-ck17_ceam_2.ndpi,Lob 9,373,273,100,26.81
PKR-2-ck17_ceam_2.ndpi,Septa 1,340,55,285,83.82
PKR-2-ck17_ceam_2.ndpi,Septa 2,301,53,248,82.39
PKR-2-ck17_ceam_2.ndpi,Septa 3,322,13,309,95.96
PKR-2-ck17_ceam_2.ndpi,Septa 4,394,68,326,82.74
PKR-2-ck17_ceam_2.ndpi,Septa 5,317,85,232,73.19
PKR-2-ck17_ceam_2.ndpi,Septa 6,373,87,286,76.68
PKR-2-ck17_ceam_2.ndpi,Septa 7,339,35,304,89.68
PKR-2-ck17_ceam_2.ndpi,Septa 9,351,24,327,93.16
PKR-2-ck17_ceam_2.ndpi,Septa 8,386,117,269,69.69
PKR-2-ck17_ceam_2.ndpi,Lob 8,366,283,83,22.68
PKR-2-ck17_ceam_2.ndpi,Lob 7,319,240,79,24.76
PKR-2-muc5ac_muc6_2.ndpi,Lob 1,762,51,711,93.31
PKR-2-muc5ac_muc6_2.ndpi,Lob 2,501,72,429,85.63
PKR-2-muc5ac_muc6_2.ndpi,Lob 3,427,39,388,90.87
PKR-2-muc5ac_muc6_2.ndpi,Lob 6,524,94,430,82.06
PKR-2-muc5ac_muc6_2.ndpi,Lob 5,460,39,421,91.52
PKR-2-muc5ac_muc6_2.ndpi,Lob 4,430,106,324,75.35
PKR-2-muc5ac_muc6_2.ndpi,Lob 7,427,211,216,50.59
PKR-2-muc5ac_muc6_2.ndpi,Lob 8,323,203,120,37.15
PKR-2-muc5ac_muc6_2.ndpi,Lob 9,439,291,148,33.71
PKR-2-muc5ac_muc6_2.ndpi,Septa 1,595,531,64,10.76
PKR-2-muc5ac_muc6_2.ndpi,Septa 2,473,357,116,24.52
PKR-2-muc5ac_muc6_2.ndpi,Septa 3,543,481,62,11.42
PKR-2-muc5ac_muc6_2.ndpi,Septa 4,550,437,113,20.55
PKR-2-muc5ac_muc6_2.ndpi,Septa 5,387,327,60,15.5
PKR-2-muc5ac_muc6_2.ndpi,Septa 6,358,302,56,15.64
PKR-2-muc5ac_muc6_2.ndpi,Septa 7,376,365,11,2.926
PKR-2-muc5ac_muc6_2.ndpi,Septa 8,409,397,12,2.934
PKR-2-muc5ac_muc6_2.ndpi,Septa 9,346,333,13,3.757
PKR-2-wt1_ca125_2.ndpi,Lob 1,338,316,22,6.509
PKR-2-wt1_ca125_2.ndpi,Lob 2,353,265,88,24.93
PKR-2-wt1_ca125_2.ndpi,Lob 3,312,216,96,30.77
PKR-2-wt1_ca125_2.ndpi,Lob 5,310,299,11,3.548
PKR-2-wt1_ca125_2.ndpi,Lob 6,313,290,23,7.348
PKR-2-wt1_ca125_2.ndpi,Lob 4,348,311,37,10.63
PKR-2-wt1_ca125_2.ndpi,Lob 7,314,226,88,28.03
PKR-2-wt1_ca125_2.ndpi,Lob 8,409,281,128,31.3
PKR-2-wt1_ca125_2.ndpi,Lob 9,492,317,175,35.57
PKR-2-wt1_ca125_2.ndpi,Septa 1,417,159,258,61.87
PKR-2-wt1_ca125_2.ndpi,Septa 2,416,65,351,84.38
PKR-2-wt1_ca125_2.ndpi,Septa 3,411,108,303,73.72
PKR-2-wt1_ca125_2.ndpi,Septa 4,357,86,271,75.91
PKR-2-wt1_ca125_2.ndpi,Septa 5,398,54,344,86.43
PKR-2-wt1_ca125_2.ndpi,Septa 6,396,93,303,76.52
PKR-2-wt1_ca125_2.ndpi,Septa 7,491,76,415,84.52
PKR-2-wt1_ca125_2.ndpi,Septa 8,337,97,240,71.22
PKR-2-wt1_ca125_2.ndpi,Septa 9,387,61,326,84.24
PKR-2-p40_ck5.ndpi,Lob 1,330,330,0,0
PKR-2-p40_ck5.ndpi,Lob 2,318,312,6,1.887
PKR-2-p40_ck5.ndpi,Lob 3,315,315,0,0
PKR-2-p40_ck5.ndpi,Lob 5,310,310,0,0
PKR-2-p40_ck5.ndpi,Lob 6,304,304,0,0
PKR-2-p40_ck5.ndpi,Lob 4,347,342,5,1.441
PKR-2-p40_ck5.ndpi,Lob 7,304,303,1,0.3289
PKR-2-p40_ck5.ndpi,Lob 8,318,311,7,2.201
PKR-2-p40_ck5.ndpi,Lob 9,303,261,42,13.86
PKR-2-p40_ck5.ndpi,Septa 1,442,184,258,58.37
PKR-2-p40_ck5.ndpi,Septa 2,314,287,27,8.599
PKR-2-p40_ck5.ndpi,Septa 3,310,287,23,7.419
PKR-2-p40_ck5.ndpi,Septa 4,306,305,1,0.3268
PKR-2-p40_ck5.ndpi,Septa 5,308,227,81,26.3
PKR-2-p40_ck5.ndpi,Septa 6,339,260,79,23.3
PKR-2-p40_ck5.ndpi,Septa 7,306,279,27,8.824
PKR-2-p40_ck5.ndpi,Septa 8,314,283,31,9.873
PKR-2-p40_ck5.ndpi,Septa 9,310,252,58,18.71
PKR-2-hmga2_ck19_2.ndpi,Lob 2,329,264,65,19.76
PKR-2-hmga2_ck19_2.ndpi,Lob 1,301,249,52,17.28
PKR-2-hmga2_ck19_2.ndpi,Lob 3,329,269,60,18.24
PKR-2-hmga2_ck19_2.ndpi,Lob 6,346,303,43,12.43
PKR-2-hmga2_ck19_2.ndpi,Lob 5,327,253,74,22.63
PKR-2-hmga2_ck19_2.ndpi,Lob 4,313,281,32,10.22
PKR-2-hmga2_ck19_2.ndpi,Lob 7,309,284,25,8.091
PKR-2-hmga2_ck19_2.ndpi,Lob 8,328,281,47,14.33
PKR-2-hmga2_ck19_2.ndpi,Lob 9,365,311,54,14.79
PKR-2-hmga2_ck19_2.ndpi,Septa 1,486,197,289,59.47
PKR-2-hmga2_ck19_2.ndpi,Septa 2,349,73,276,79.08
PKR-2-hmga2_ck19_2.ndpi,Septa 3,424,113,311,73.35
PKR-2-hmga2_ck19_2.ndpi,Septa 4,317,151,166,52.37
PKR-2-hmga2_ck19_2.ndpi,Septa 5,314,159,155,49.36
PKR-2-hmga2_ck19_2.ndpi,Septa 6,311,182,129,41.48
PKR-2-hmga2_ck19_2.ndpi,Septa 7,308,131,177,57.47
PKR-2-hmga2_ck19_2.ndpi,Septa 8,331,102,229,69.18
PKR-2-hmga2_ck19_2.ndpi,Septa 9,314,119,195,62.1
PKR-2-cdx2_ca199.ndpi,Lob 1,322,264,58,18.01
PKR-2-cdx2_ca199.ndpi,Lob 3,318,288,30,9.434
PKR-2-cdx2_ca199.ndpi,Lob 2,302,285,17,5.629
PKR-2-cdx2_ca199.ndpi,Lob 6,314,260,54,17.2
PKR-2-cdx2_ca199.ndpi,Lob 5,304,257,47,15.46
PKR-2-cdx2_ca199.ndpi,Lob 4,317,286,31,9.779
PKR-2-cdx2_ca199.ndpi,Lob 8,302,294,8,2.649
PKR-2-cdx2_ca199.ndpi,Lob 7,349,331,18,5.158
PKR-2-cdx2_ca199.ndpi,Lob 9,334,321,13,3.892
PKR-2-cdx2_ca199.ndpi,Septa 1,304,303,1,0.3289
PKR-2-cdx2_ca199.ndpi,Septa 2,315,314,1,0.3175
PKR-2-cdx2_ca199.ndpi,Septa 3,303,303,0,0
PKR-2-cdx2_ca199.ndpi,Septa 4,327,327,0,0
PKR-2-cdx2_ca199.ndpi,Septa 5,302,301,1,0.3311
PKR-2-cdx2_ca199.ndpi,Septa 6,359,357,2,0.5571
PKR-2-cdx2_ca199.ndpi,Septa 7,307,306,1,0.3257
PKR-2-cdx2_ca199.ndpi,Septa 8,322,321,1,0.3106
PKR-2-cdx2_ca199.ndpi,Septa 9,308,308,0,0
